.........................
..........CC.............
.........................
...############...##.....
...####..................
......#.......#####......
....A.........#...#......
..............#####......
......#..................
......#..............B...
....#####....####........
...#....#....#...#.......
....#...#.....#...#......
....#...#.....#...#......
....#...#.....#...#......
....#...#.....#...#......
....#####......####......
.........................
.........................
....################.....
....################.....
.........................
.........................
..........TT.............
.........................
