.........................
........CC...............
.......#########.........
.........................
.........................
......###....###.....####
......#........#.........
......#.....#..#.........
......#.....#..#.........
..B...#.....#..#...A.....
............#..#....#....
........#...#..#....#....
............#..#....#....
....###.....#...#...#....
......#.....#...#...#....
......#.....#...#........
......#.....#...#........
..#...#.....#...#........
..#...#.....#...#........
###...#...###...#........
.........................
.........................
.........................
..........TT.............
.........................
